11111111111111111111111111
1P000000000100000000000001
10000C00000100000000000001
10000000000000000E00000001
10000000111100000000000001
10000000100111110011111111
11111101100100000000000001
10000100000000000000C00001
10C00000000100000000000001
11111111111111111111111111