
111111111111111
100000010000001
1P0000010000001
100001110Q00001
101000010000001
11100000000C001
111000111111111
111E10000000001
100010000000001
1111100Q000C001
100000000000001
111111111111111

