11111111111111
1P0000EC000001
10000000000001
10000000000001
10000100000001
11111111111111