111111111
110101011
101010101
11E101011
1P1C10101
111111111