
111111111111111
10Q000010000001
1P0000010000Q01
100001110Q00001
101000010000001
11100000000C001
111000111111111
111E100000Q0001
1000100000000Q1
11111000Q00C001
1000000Q000Q001
111111111111111

