


1111111111111111111111111111111111
1C0000000000000C00000C0000000000C1
10100101001000001E1001000000010101
1010010010101010001001000000010101
1P000000C00C0000000000000000000C01
1111111111111111111111111111111111


