1111111111111
1P00000000011
1000000000011
10000C0000011
100000000E011
10000C0000011
1111111111111