1111111111111
1P00000000011
1000000000011
10000C0001111
1000000001C11
10000C000E011
1111111111111