


11111111
1PCC0E11
11111111
11111111
11111111
11111111
11111111
11111111
11111111
11111111
11111111
11111111
11111111
11111111
111Q1111
11111111

