11111111111111111111111111111
1CQ000000000000C00000C0000001
101001010Q1000001E1001000Q001
10100100101010100010010000001
1P000000C00C00000000000Q00001
11111111111111111111111111111