11111111111111
1P00C1E0000001
11111111111111
10000000000001
10000100000001
11111111111111