11111111111111111111111111111111
1000000000000000000000C000000001
1000000P000000000000000000000001
100C00000000000C0000000000000001
10000000000000000000000000000001
10000000000000000000000000E00001
11111111111111111111111111111111